111111111111
100000P00001
101011000111
1C1000CC0011
1C1000CC0011
1C1000CC0011
1C1000CC0011
1C10C01C0011
1C1000CC0011
1C1000C10011
1E11111C0011
111111111111
