1111111111111111111111111
100000P000000000000000001
1010110001111000000000001
1C1000CC00111000000000001
1C1000CC00111000000000001
1010000000111000000000001
1C1000CC0011100000000C001
1C10C01C00111000000000001
1C1000CC00111000000000001
1C1000C100111000000000001
1E11111C00111000000000001
1111111111111111111111111
