1111111111111
100000P000001
00111100001E1
1C1000CC001C0
1111111111110
