1111111111111
100000P000001
10111100001E1
1010000000101
1111111111111
