1111111111111
100000P000011
10111100001E1
1C1000CC00101
1111111111111
